20 14
00000000000000
0A          D0
0    789     0
0    6 5     0
0    432     0
0            0
0            0
0            0
0            0
0            0
0    789     0
0    6 5     0
0    432     0
0            0
0            0
0            0
0            0
0            0
0C          B0
00000000000000
00000000000000
0            0
0            0
0            0
0            0
0            0
0            0
0            0
0            0
0            0
0            0
0            0
0            0
0            0
0            0
0            0
0            0
0            0
0            0
00000000000000
