09 11
00000000000
0A        0
0         0
00        0
000       0
0000      0
0C000     0
0BD000    0
00000000000
00000000000
0         0
0         0
0         0
0         0
0         0
0         0
0         0
00000000000
