09 11
00000000000
0      BCD0
0    111110
0         0
09  1111110
0       1 0
0   A   1 0
05        0
00000000000
00000000000
0         0
0         0
0         0
0         0
0         0
0         0
0         0
00000000000
