10 14
00000000000000
0           D0
0            0
0            0
0     A      0
0            0
0            0
0            0
0C          B0
00000000000000
00000000000000
0            0
0            0
0            0
0            0
0            0
0            0
0            0
0            0
00000000000000
