09 11
00000000000
0A   94BCD0
0         0
0         0
09       90
0         0
0         0
05   9    0
00000000000
00000000000
0         0
0         0
0         0
0         0
0         0
0         0
0         0
00000000000
