09 11
00000000000
0A  111  B0
0 0 010 0 0
0    1    0
01010101010
0    1    0
0 0 010 0 0
0C  111  D0
00000000000
00000000000
0    +    0
0         0
0    #    0
0+ # + # +0
0    #    0
0         0
0    +    0
00000000000
