09 11
00000000000
0A       B0
0         0
0         0
0         0
0         0
0         0
0C       D0
00000000000
00000000000
0    +    0
0         0
0    #    0
0+ # + # +0
0    #    0
0         0
0    +    0
00000000000
